"filename", "language", "JavaScript", "CSS", "XML", "SCSS", "comment", "blank", "total"
"c:\Users\syedh\OneDrive\Desktop\Antive\src\Agenda\components\AddProject.js", "JavaScript", 81, 0, 0, 0, 79, 12, 172
"c:\Users\syedh\OneDrive\Desktop\Antive\src\Agenda\components\AddTask.js", "JavaScript", 174, 0, 0, 0, 169, 21, 364
"c:\Users\syedh\OneDrive\Desktop\Antive\src\Agenda\components\Checkbox.js", "JavaScript", 21, 0, 0, 0, 1, 4, 26
"c:\Users\syedh\OneDrive\Desktop\Antive\src\Agenda\components\IndividualProject.js", "JavaScript", 59, 0, 0, 0, 1, 4, 64
"c:\Users\syedh\OneDrive\Desktop\Antive\src\Agenda\components\ProjectOverlay.js", "JavaScript", 44, 0, 0, 0, 0, 3, 47
"c:\Users\syedh\OneDrive\Desktop\Antive\src\Agenda\components\Projects.js", "JavaScript", 32, 0, 0, 0, 0, 4, 36
"c:\Users\syedh\OneDrive\Desktop\Antive\src\Agenda\components\TaskDate.js", "JavaScript", 85, 0, 0, 0, 0, 2, 87
"c:\Users\syedh\OneDrive\Desktop\Antive\src\Agenda\components\Tasks.js", "JavaScript", 43, 0, 0, 0, 0, 8, 51
"c:\Users\syedh\OneDrive\Desktop\Antive\src\Agenda\components\layout\AgendaElements.js", "JavaScript", 66, 0, 0, 0, 10, 12, 88
"c:\Users\syedh\OneDrive\Desktop\Antive\src\Agenda\components\layout\Content.js", "JavaScript", 9, 0, 0, 0, 0, 3, 12
"c:\Users\syedh\OneDrive\Desktop\Antive\src\Agenda\components\layout\HeaderAgenda.css", "CSS", 0, 11, 0, 0, 1, 4, 16
"c:\Users\syedh\OneDrive\Desktop\Antive\src\Agenda\components\layout\HeaderAgenda.js", "JavaScript", 48, 0, 0, 0, 6, 10, 64
"c:\Users\syedh\OneDrive\Desktop\Antive\src\Agenda\components\layout\SidebarAgenda.js", "JavaScript", 127, 0, 0, 0, 6, 5, 138
"c:\Users\syedh\OneDrive\Desktop\Antive\src\Agenda\constants\index.js", "JavaScript", 5, 0, 0, 0, 0, 0, 5
"c:\Users\syedh\OneDrive\Desktop\Antive\src\Agenda\context\index.js", "JavaScript", 18, 0, 0, 0, 0, 3, 21
"c:\Users\syedh\OneDrive\Desktop\Antive\src\Agenda\context\projects-context.js", "JavaScript", 16, 0, 0, 0, 0, 4, 20
"c:\Users\syedh\OneDrive\Desktop\Antive\src\Agenda\context\selected-project-context.js", "JavaScript", 17, 0, 0, 0, 0, 4, 21
"c:\Users\syedh\OneDrive\Desktop\Antive\src\Agenda\helpers\index.js", "JavaScript", 25, 0, 0, 0, 0, 10, 35
"c:\Users\syedh\OneDrive\Desktop\Antive\src\Agenda\hooks\index.js", "JavaScript", 67, 0, 0, 0, 66, 24, 157
"c:\Users\syedh\OneDrive\Desktop\Antive\src\App.css", "CSS", 0, 11, 0, 0, 1, 2, 14
"c:\Users\syedh\OneDrive\Desktop\Antive\src\App.js", "JavaScript", 71, 0, 0, 0, 31, 9, 111
"c:\Users\syedh\OneDrive\Desktop\Antive\src\App.scss", "SCSS", 0, 0, 0, 718, 53, 98, 869
"c:\Users\syedh\OneDrive\Desktop\Antive\src\Budget\Balance.js", "JavaScript", 23, 0, 0, 0, 5, 4, 32
"c:\Users\syedh\OneDrive\Desktop\Antive\src\Budget\BudgetPages.css", "CSS", 0, 6, 0, 0, 0, 1, 7
"c:\Users\syedh\OneDrive\Desktop\Antive\src\Budget\BudgetPages.js", "JavaScript", 50, 0, 0, 0, 4, 14, 68
"c:\Users\syedh\OneDrive\Desktop\Antive\src\Budget\DashboardExpenseCard.js", "JavaScript", 104, 0, 0, 0, 44, 14, 162
"c:\Users\syedh\OneDrive\Desktop\Antive\src\Budget\ExpenseCard.js", "JavaScript", 88, 0, 0, 0, 23, 12, 123
"c:\Users\syedh\OneDrive\Desktop\Antive\src\Budget\NewTransaction.js", "JavaScript", 112, 0, 0, 0, 0, 7, 119
"c:\Users\syedh\OneDrive\Desktop\Antive\src\Budget\Transaction.js", "JavaScript", 88, 0, 0, 0, 15, 9, 112
"c:\Users\syedh\OneDrive\Desktop\Antive\src\Budget\TransactionDash.js", "JavaScript", 110, 0, 0, 0, 17, 10, 137
"c:\Users\syedh\OneDrive\Desktop\Antive\src\Budget\TransactionIterate.js", "JavaScript", 36, 0, 0, 0, 4, 6, 46
"c:\Users\syedh\OneDrive\Desktop\Antive\src\Budget\styles.css", "CSS", 0, 73, 0, 0, 6, 12, 91
"c:\Users\syedh\OneDrive\Desktop\Antive\src\Chat2\components\ChatFeed.js", "JavaScript", 78, 0, 0, 0, 0, 10, 88
"c:\Users\syedh\OneDrive\Desktop\Antive\src\Chat2\components\MessageForm.js", "JavaScript", 49, 0, 0, 0, 0, 10, 59
"c:\Users\syedh\OneDrive\Desktop\Antive\src\Chat2\components\MyMessage.js", "JavaScript", 18, 0, 0, 0, 0, 2, 20
"c:\Users\syedh\OneDrive\Desktop\Antive\src\Chat2\components\TheirMessage.js", "JavaScript", 28, 0, 0, 0, 0, 2, 30
"c:\Users\syedh\OneDrive\Desktop\Antive\src\Chat2\page\Chatdisplaypage.js", "JavaScript", 19, 0, 0, 0, 3, 7, 29
"c:\Users\syedh\OneDrive\Desktop\Antive\src\Chat2\styles\chatstyles.css", "CSS", 0, 0, 0, 0, 296, 1, 297
"c:\Users\syedh\OneDrive\Desktop\Antive\src\Chat\components\Chats.js", "JavaScript", 95, 0, 0, 0, 10, 17, 122
"c:\Users\syedh\OneDrive\Desktop\Antive\src\Chat\index.css", "CSS", 0, 367, 0, 0, 79, 68, 514
"c:\Users\syedh\OneDrive\Desktop\Antive\src\ComingSoon\ComingSoon.css", "CSS", 0, 44, 0, 0, 0, 8, 52
"c:\Users\syedh\OneDrive\Desktop\Antive\src\ComingSoon\ComingSoon.js", "JavaScript", 39, 0, 0, 0, 1, 4, 44
"c:\Users\syedh\OneDrive\Desktop\Antive\src\ComingSoon\ComingSoonElements.js", "JavaScript", 20, 0, 0, 0, 0, 3, 23
"c:\Users\syedh\OneDrive\Desktop\Antive\src\Dashboard\DriveElements.js", "JavaScript", 17, 0, 0, 0, 0, 4, 21
"c:\Users\syedh\OneDrive\Desktop\Antive\src\Dashboard\components\BudgetDash.js", "JavaScript", 0, 0, 0, 0, 0, 1, 1
"c:\Users\syedh\OneDrive\Desktop\Antive\src\Dashboard\components\DriveDash.js", "JavaScript", 63, 0, 0, 0, 5, 8, 76
"c:\Users\syedh\OneDrive\Desktop\Antive\src\Dashboard\components\TaskDash.js", "JavaScript", 0, 0, 0, 0, 0, 1, 1
"c:\Users\syedh\OneDrive\Desktop\Antive\src\Dashboard\dashboard.css", "CSS", 0, 163, 0, 0, 22, 32, 217
"c:\Users\syedh\OneDrive\Desktop\Antive\src\Dashboard\index.js", "JavaScript", 64, 0, 0, 0, 63, 7, 134
"c:\Users\syedh\OneDrive\Desktop\Antive\src\Dashboard\pages\BudgetDashPage.js", "JavaScript", 11, 0, 0, 0, 2, 3, 16
"c:\Users\syedh\OneDrive\Desktop\Antive\src\Dashboard\pages\DriveDashPage.js", "JavaScript", 16, 0, 0, 0, 2, 5, 23
"c:\Users\syedh\OneDrive\Desktop\Antive\src\Dashboard\pages\TaskDashPage.js", "JavaScript", 15, 0, 0, 0, 3, 5, 23
"c:\Users\syedh\OneDrive\Desktop\Antive\src\Drive\components\Buttons\AddFileButton.js", "JavaScript", 132, 0, 0, 0, 125, 27, 284
"c:\Users\syedh\OneDrive\Desktop\Antive\src\Drive\components\Buttons\AddFolderButton.js", "JavaScript", 98, 0, 0, 0, 0, 11, 109
"c:\Users\syedh\OneDrive\Desktop\Antive\src\Drive\components\Buttons\HomeButton.js", "JavaScript", 20, 0, 0, 0, 0, 2, 22
"c:\Users\syedh\OneDrive\Desktop\Antive\src\Drive\components\files\File.js", "JavaScript", 101, 0, 0, 0, 0, 6, 107
"c:\Users\syedh\OneDrive\Desktop\Antive\src\Drive\components\files\FilesEmptyState.js", "JavaScript", 22, 0, 0, 0, 0, 2, 24
"c:\Users\syedh\OneDrive\Desktop\Antive\src\Drive\components\files\FilesTable.js", "JavaScript", 27, 0, 0, 0, 0, 2, 29
"c:\Users\syedh\OneDrive\Desktop\Antive\src\Drive\components\files\FilesTableSkeleton.js", "JavaScript", 45, 0, 0, 0, 0, 3, 48
"c:\Users\syedh\OneDrive\Desktop\Antive\src\Drive\components\folders\Folder.js", "JavaScript", 73, 0, 0, 0, 10, 10, 93
"c:\Users\syedh\OneDrive\Desktop\Antive\src\Drive\components\folders\FolderGrid.js", "JavaScript", 13, 0, 0, 0, 0, 2, 15
"c:\Users\syedh\OneDrive\Desktop\Antive\src\Drive\components\layout\DashboardDrive.js", "JavaScript", 190, 0, 0, 0, 12, 17, 219
"c:\Users\syedh\OneDrive\Desktop\Antive\src\Drive\components\layout\DashboardDriveElements.js", "JavaScript", 39, 0, 0, 0, 1, 8, 48
"c:\Users\syedh\OneDrive\Desktop\Antive\src\Drive\components\layout\FolderBreadCrumbs.js", "JavaScript", 48, 0, 0, 0, 0, 3, 51
"c:\Users\syedh\OneDrive\Desktop\Antive\src\Drive\components\popupmodal\Modal.css", "CSS", 0, 24, 0, 0, 0, 4, 28
"c:\Users\syedh\OneDrive\Desktop\Antive\src\Drive\components\popupmodal\Modal.js", "JavaScript", 144, 0, 0, 0, 0, 15, 159
"c:\Users\syedh\OneDrive\Desktop\Antive\src\Drive\hooks\useFolder.js", "JavaScript", 132, 0, 0, 0, 132, 21, 285
"c:\Users\syedh\OneDrive\Desktop\Antive\src\Drive\utilities\CenterContainer.js", "JavaScript", 21, 0, 0, 0, 0, 3, 24
"c:\Users\syedh\OneDrive\Desktop\Antive\src\Drive\utilities\theme.js", "JavaScript", 7, 0, 0, 0, 0, 2, 9
"c:\Users\syedh\OneDrive\Desktop\Antive\src\Forgotpass\forgotpass.css", "CSS", 0, 210, 0, 0, 26, 26, 262
"c:\Users\syedh\OneDrive\Desktop\Antive\src\Forgotpass\forgotpass.js", "JavaScript", 47, 0, 0, 0, 0, 8, 55
"c:\Users\syedh\OneDrive\Desktop\Antive\src\Forgotpass\image\forgotpass.svg", "XML", 0, 0, 1, 0, 0, 0, 1
"c:\Users\syedh\OneDrive\Desktop\Antive\src\Forgotpass\index.js", "JavaScript", 27, 0, 0, 0, 0, 3, 30
"c:\Users\syedh\OneDrive\Desktop\Antive\src\LandingPage\components\ButtonElements.js", "JavaScript", 22, 0, 0, 0, 0, 2, 24
"c:\Users\syedh\OneDrive\Desktop\Antive\src\LandingPage\components\Footer\FooterElements.js", "JavaScript", 160, 0, 0, 0, 6, 10, 176
"c:\Users\syedh\OneDrive\Desktop\Antive\src\LandingPage\components\Footer\index.js", "JavaScript", 64, 0, 0, 0, 0, 5, 69
"c:\Users\syedh\OneDrive\Desktop\Antive\src\LandingPage\components\Hero\HeroElements.js", "JavaScript", 94, 0, 0, 0, 1, 5, 100
"c:\Users\syedh\OneDrive\Desktop\Antive\src\LandingPage\components\Hero\index.js", "JavaScript", 27, 0, 0, 0, 0, 4, 31
"c:\Users\syedh\OneDrive\Desktop\Antive\src\LandingPage\components\Info\Data.js", "JavaScript", 68, 0, 0, 0, 0, 4, 72
"c:\Users\syedh\OneDrive\Desktop\Antive\src\LandingPage\components\Info\InfoElements.js", "JavaScript", 99, 0, 0, 0, 0, 3, 102
"c:\Users\syedh\OneDrive\Desktop\Antive\src\LandingPage\components\Info\index.js", "JavaScript", 57, 0, 0, 0, 1, 3, 61
"c:\Users\syedh\OneDrive\Desktop\Antive\src\LandingPage\components\Navbar\NavbarElements.js", "JavaScript", 125, 0, 0, 0, 1, 6, 132
"c:\Users\syedh\OneDrive\Desktop\Antive\src\LandingPage\components\Navbar\index.js", "JavaScript", 64, 0, 0, 0, 11, 7, 82
"c:\Users\syedh\OneDrive\Desktop\Antive\src\LandingPage\components\ScrollToTop.js", "JavaScript", 9, 0, 0, 0, 0, 3, 12
"c:\Users\syedh\OneDrive\Desktop\Antive\src\LandingPage\components\Services\ServiceElements.js", "JavaScript", 75, 0, 0, 0, 0, 3, 78
"c:\Users\syedh\OneDrive\Desktop\Antive\src\LandingPage\components\Services\index.js", "JavaScript", 36, 0, 0, 0, 0, 2, 38
"c:\Users\syedh\OneDrive\Desktop\Antive\src\LandingPage\components\SideBar\SidebarElements.js", "JavaScript", 89, 0, 0, 0, 1, 4, 94
"c:\Users\syedh\OneDrive\Desktop\Antive\src\LandingPage\components\SideBar\index.js", "JavaScript", 34, 0, 0, 0, 2, 3, 39
"c:\Users\syedh\OneDrive\Desktop\Antive\src\LandingPage\images\EasyAccess.svg", "XML", 0, 0, 1, 0, 0, 0, 1
"c:\Users\syedh\OneDrive\Desktop\Antive\src\LandingPage\images\Privacy.svg", "XML", 0, 0, 1, 0, 0, 0, 1
"c:\Users\syedh\OneDrive\Desktop\Antive\src\LandingPage\images\Security.svg", "XML", 0, 0, 1, 0, 0, 0, 1
"c:\Users\syedh\OneDrive\Desktop\Antive\src\LandingPage\images\ToolUnity.svg", "XML", 0, 0, 1, 0, 0, 0, 1
"c:\Users\syedh\OneDrive\Desktop\Antive\src\LandingPage\images\ToolUnity1.svg", "XML", 0, 0, 1, 0, 0, 0, 1
"c:\Users\syedh\OneDrive\Desktop\Antive\src\LandingPage\images\VarietyOptions.svg", "XML", 0, 0, 1, 0, 0, 0, 1
"c:\Users\syedh\OneDrive\Desktop\Antive\src\LandingPage\images\svg-1.svg", "XML", 0, 0, 45, 0, 0, 1, 46
"c:\Users\syedh\OneDrive\Desktop\Antive\src\LandingPage\images\svg-3.svg", "XML", 0, 0, 46, 0, 0, 1, 47
"c:\Users\syedh\OneDrive\Desktop\Antive\src\LandingPage\images\svg-4.svg", "XML", 0, 0, 41, 0, 0, 1, 42
"c:\Users\syedh\OneDrive\Desktop\Antive\src\LandingPage\images\svg-5.svg", "XML", 0, 0, 72, 0, 0, 1, 73
"c:\Users\syedh\OneDrive\Desktop\Antive\src\Login\Login.css", "CSS", 0, 295, 0, 0, 20, 34, 349
"c:\Users\syedh\OneDrive\Desktop\Antive\src\Login\Login.js", "JavaScript", 94, 0, 0, 0, 6, 12, 112
"c:\Users\syedh\OneDrive\Desktop\Antive\src\Login\image\login.svg", "XML", 0, 0, 1, 0, 0, 0, 1
"c:\Users\syedh\OneDrive\Desktop\Antive\src\Login\index.js", "JavaScript", 25, 0, 0, 0, 0, 3, 28
"c:\Users\syedh\OneDrive\Desktop\Antive\src\Login\toastInfo.js", "JavaScript", 14, 0, 0, 0, 0, 1, 15
"c:\Users\syedh\OneDrive\Desktop\Antive\src\OfficialForgotPass\OfficialForgotPass.css", "CSS", 0, 235, 0, 0, 9, 27, 271
"c:\Users\syedh\OneDrive\Desktop\Antive\src\OfficialForgotPass\OfficialForgotPass.js", "JavaScript", 80, 0, 0, 0, 4, 11, 95
"c:\Users\syedh\OneDrive\Desktop\Antive\src\OfficialForgotPass\image\forgotpass.svg", "XML", 0, 0, 1, 0, 0, 0, 1
"c:\Users\syedh\OneDrive\Desktop\Antive\src\OfficialLandingPage\Pages\Home.js", "JavaScript", 58, 0, 0, 0, 7, 6, 71
"c:\Users\syedh\OneDrive\Desktop\Antive\src\OfficialLandingPage\Sections\About\index.js", "JavaScript", 144, 0, 0, 0, 0, 14, 158
"c:\Users\syedh\OneDrive\Desktop\Antive\src\OfficialLandingPage\Sections\Contact\index.js", "JavaScript", 169, 0, 0, 0, 2, 7, 178
"c:\Users\syedh\OneDrive\Desktop\Antive\src\OfficialLandingPage\Sections\Hero\index.js", "JavaScript", 216, 0, 0, 0, 12, 25, 253
"c:\Users\syedh\OneDrive\Desktop\Antive\src\OfficialLandingPage\Sections\PlainFooter\MinimalFooter.js", "JavaScript", 82, 0, 0, 0, 2, 8, 92
"c:\Users\syedh\OneDrive\Desktop\Antive\src\OfficialLandingPage\Sections\PlainServices\TwoColSingleFeatureWithStats2\TwoColSingleFeatureWithStats2.js", "JavaScript", 107, 0, 0, 0, 2, 11, 120
"c:\Users\syedh\OneDrive\Desktop\Antive\src\OfficialLandingPage\Sections\PlainServices\TwoColWithButton\TwoColWithButton.js", "JavaScript", 75, 0, 0, 0, 1, 10, 86
"c:\Users\syedh\OneDrive\Desktop\Antive\src\OfficialLandingPage\Sections\PlainServices\TwoColWithTwoHorizontalFeaturesAndButton\TwoColHorizontalFeaturesfour.js", "JavaScript", 142, 0, 0, 0, 6, 15, 163
"c:\Users\syedh\OneDrive\Desktop\Antive\src\OfficialLandingPage\Sections\PlainServices\TwoColWithTwoHorizontalFeaturesAndButton\TwoColHorizontalFeaturesthree.js", "JavaScript", 142, 0, 0, 0, 6, 15, 163
"c:\Users\syedh\OneDrive\Desktop\Antive\src\OfficialLandingPage\Sections\PlainServices\TwoColWithTwoHorizontalFeaturesAndButton\TwoColHorizontalFeaturestwo.js", "JavaScript", 142, 0, 0, 0, 6, 15, 163
"c:\Users\syedh\OneDrive\Desktop\Antive\src\OfficialLandingPage\Sections\PlainServices\TwoColWithTwoHorizontalFeaturesAndButton\TwoColWithTwoHorizontalFeaturesAndButton.js", "JavaScript", 142, 0, 0, 0, 6, 15, 163
"c:\Users\syedh\OneDrive\Desktop\Antive\src\OfficialLandingPage\Sections\PlainServices\images\Budget.svg", "XML", 0, 0, 1, 0, 0, 0, 1
"c:\Users\syedh\OneDrive\Desktop\Antive\src\OfficialLandingPage\Sections\PlainServices\images\Chat.svg", "XML", 0, 0, 1, 0, 0, 0, 1
"c:\Users\syedh\OneDrive\Desktop\Antive\src\OfficialLandingPage\Sections\PlainServices\images\TodoList.svg", "XML", 0, 0, 1, 0, 0, 0, 1
"c:\Users\syedh\OneDrive\Desktop\Antive\src\OfficialLandingPage\Sections\PlainServices\images\Vault.svg", "XML", 0, 0, 1, 0, 0, 0, 1
"c:\Users\syedh\OneDrive\Desktop\Antive\src\OfficialLandingPage\Sections\PlainServices\images\arrow-left-2-icon.svg", "XML", 0, 0, 4, 0, 0, 1, 5
"c:\Users\syedh\OneDrive\Desktop\Antive\src\OfficialLandingPage\Sections\PlainServices\images\arrow-left-3-icon.svg", "XML", 0, 0, 1, 0, 0, 1, 2
"c:\Users\syedh\OneDrive\Desktop\Antive\src\OfficialLandingPage\Sections\PlainServices\images\arrow-right-2-icon.svg", "XML", 0, 0, 3, 0, 0, 1, 4
"c:\Users\syedh\OneDrive\Desktop\Antive\src\OfficialLandingPage\Sections\PlainServices\images\arrow-right-3-icon.svg", "XML", 0, 0, 1, 0, 0, 1, 2
"c:\Users\syedh\OneDrive\Desktop\Antive\src\OfficialLandingPage\Sections\PlainServices\images\arrow-right-icon.svg", "XML", 0, 0, 3, 0, 0, 1, 4
"c:\Users\syedh\OneDrive\Desktop\Antive\src\OfficialLandingPage\Sections\PlainServices\images\celebration-icon.svg", "XML", 0, 0, 1, 0, 0, 0, 1
"c:\Users\syedh\OneDrive\Desktop\Antive\src\OfficialLandingPage\Sections\PlainServices\images\checkbox-circle.svg", "XML", 0, 0, 4, 0, 0, 1, 5
"c:\Users\syedh\OneDrive\Desktop\Antive\src\OfficialLandingPage\Sections\PlainServices\images\chef-icon.svg", "XML", 0, 0, 1, 0, 0, 0, 1
"c:\Users\syedh\OneDrive\Desktop\Antive\src\OfficialLandingPage\Sections\PlainServices\images\contact-us-illustration.svg", "XML", 0, 0, 1, 0, 0, 0, 1
"c:\Users\syedh\OneDrive\Desktop\Antive\src\OfficialLandingPage\Sections\PlainServices\images\customer-support-illustration.svg", "XML", 0, 0, 1, 0, 0, 0, 1
"c:\Users\syedh\OneDrive\Desktop\Antive\src\OfficialLandingPage\Sections\PlainServices\images\customize-icon.svg", "XML", 0, 0, 1, 0, 0, 0, 1
"c:\Users\syedh\OneDrive\Desktop\Antive\src\OfficialLandingPage\Sections\PlainServices\images\design-illustration-2.svg", "XML", 0, 0, 1, 0, 0, 0, 1
"c:\Users\syedh\OneDrive\Desktop\Antive\src\OfficialLandingPage\Sections\PlainServices\images\design-illustration.svg", "XML", 0, 0, 1, 0, 0, 0, 1
"c:\Users\syedh\OneDrive\Desktop\Antive\src\OfficialLandingPage\Sections\PlainServices\images\dot-pattern copy.svg", "XML", 0, 0, 3, 0, 0, 1, 4
"c:\Users\syedh\OneDrive\Desktop\Antive\src\OfficialLandingPage\Sections\PlainServices\images\dot-pattern.svg", "XML", 0, 0, 3, 0, 0, 1, 4
"c:\Users\syedh\OneDrive\Desktop\Antive\src\OfficialLandingPage\Sections\PlainServices\images\email-illustration.svg", "XML", 0, 0, 1, 0, 0, 0, 1
"c:\Users\syedh\OneDrive\Desktop\Antive\src\OfficialLandingPage\Sections\PlainServices\images\email-newsletter-icon.svg", "XML", 0, 0, 8, 0, 0, 1, 9
"c:\Users\syedh\OneDrive\Desktop\Antive\src\OfficialLandingPage\Sections\PlainServices\images\facebook-icon.svg", "XML", 0, 0, 3, 0, 0, 1, 4
"c:\Users\syedh\OneDrive\Desktop\Antive\src\OfficialLandingPage\Sections\PlainServices\images\fast-icon.svg", "XML", 0, 0, 1, 0, 0, 0, 1
"c:\Users\syedh\OneDrive\Desktop\Antive\src\OfficialLandingPage\Sections\PlainServices\images\girl-illustration.svg", "XML", 0, 0, 1, 0, 0, 0, 1
"c:\Users\syedh\OneDrive\Desktop\Antive\src\OfficialLandingPage\Sections\PlainServices\images\github-icon.svg", "XML", 0, 0, 9, 0, 0, 1, 10
"c:\Users\syedh\OneDrive\Desktop\Antive\src\OfficialLandingPage\Sections\PlainServices\images\handle-icon.svg", "XML", 0, 0, 4, 0, 0, 1, 5
"c:\Users\syedh\OneDrive\Desktop\Antive\src\OfficialLandingPage\Sections\PlainServices\images\happy-illustration.svg", "XML", 0, 0, 1, 0, 0, 0, 1
"c:\Users\syedh\OneDrive\Desktop\Antive\src\OfficialLandingPage\Sections\PlainServices\images\linkedin-icon.svg", "XML", 0, 0, 4, 0, 0, 1, 5
"c:\Users\syedh\OneDrive\Desktop\Antive\src\OfficialLandingPage\Sections\PlainServices\images\love-illustration.svg", "XML", 0, 0, 1, 0, 0, 0, 1
"c:\Users\syedh\OneDrive\Desktop\Antive\src\OfficialLandingPage\Sections\PlainServices\images\professional-illustration.svg", "XML", 0, 0, 1, 0, 0, 0, 1
"c:\Users\syedh\OneDrive\Desktop\Antive\src\OfficialLandingPage\Sections\PlainServices\images\prototype-illustration.svg", "XML", 0, 0, 1, 0, 0, 0, 1
"c:\Users\syedh\OneDrive\Desktop\Antive\src\OfficialLandingPage\Sections\PlainServices\images\quotes-l.svg", "XML", 0, 0, 4, 0, 0, 1, 5
"c:\Users\syedh\OneDrive\Desktop\Antive\src\OfficialLandingPage\Sections\PlainServices\images\quotes-r.svg", "XML", 0, 0, 4, 0, 0, 1, 5
"c:\Users\syedh\OneDrive\Desktop\Antive\src\OfficialLandingPage\Sections\PlainServices\images\reliable-icon.svg", "XML", 0, 0, 1, 0, 0, 0, 1
"c:\Users\syedh\OneDrive\Desktop\Antive\src\OfficialLandingPage\Sections\PlainServices\images\server-illustration-2.svg", "XML", 0, 0, 1, 0, 0, 0, 1
"c:\Users\syedh\OneDrive\Desktop\Antive\src\OfficialLandingPage\Sections\PlainServices\images\server-illustration.svg", "XML", 0, 0, 80, 0, 0, 1, 81
"c:\Users\syedh\OneDrive\Desktop\Antive\src\OfficialLandingPage\Sections\PlainServices\images\server-redundancy-illustration.svg", "XML", 0, 0, 1, 0, 0, 0, 1
"c:\Users\syedh\OneDrive\Desktop\Antive\src\OfficialLandingPage\Sections\PlainServices\images\server-secure-illustration.svg", "XML", 0, 0, 1, 0, 0, 0, 1
"c:\Users\syedh\OneDrive\Desktop\Antive\src\OfficialLandingPage\Sections\PlainServices\images\shield-icon.svg", "XML", 0, 0, 1, 0, 0, 0, 1
"c:\Users\syedh\OneDrive\Desktop\Antive\src\OfficialLandingPage\Sections\PlainServices\images\shop-icon.svg", "XML", 0, 0, 1, 0, 0, 0, 1
"c:\Users\syedh\OneDrive\Desktop\Antive\src\OfficialLandingPage\Sections\PlainServices\images\signup-illustration.svg", "XML", 0, 0, 1, 0, 0, 0, 1
"c:\Users\syedh\OneDrive\Desktop\Antive\src\OfficialLandingPage\Sections\PlainServices\images\simple-icon.svg", "XML", 0, 0, 1, 0, 0, 0, 1
"c:\Users\syedh\OneDrive\Desktop\Antive\src\OfficialLandingPage\Sections\PlainServices\images\star-icon.svg", "XML", 0, 0, 3, 0, 0, 1, 4
"c:\Users\syedh\OneDrive\Desktop\Antive\src\OfficialLandingPage\Sections\PlainServices\images\stats-illustration.svg", "XML", 0, 0, 1, 0, 0, 0, 1
"c:\Users\syedh\OneDrive\Desktop\Antive\src\OfficialLandingPage\Sections\PlainServices\images\support-icon.svg", "XML", 0, 0, 1, 0, 0, 0, 1
"c:\Users\syedh\OneDrive\Desktop\Antive\src\OfficialLandingPage\Sections\PlainServices\images\svg-decorator-blob-1.svg", "XML", 0, 0, 11, 0, 0, 1, 12
"c:\Users\syedh\OneDrive\Desktop\Antive\src\OfficialLandingPage\Sections\PlainServices\images\svg-decorator-blob-10.svg", "XML", 0, 0, 6, 0, 0, 1, 7
"c:\Users\syedh\OneDrive\Desktop\Antive\src\OfficialLandingPage\Sections\PlainServices\images\svg-decorator-blob-2.svg", "XML", 0, 0, 11, 0, 1, 1, 13
"c:\Users\syedh\OneDrive\Desktop\Antive\src\OfficialLandingPage\Sections\PlainServices\images\svg-decorator-blob-3.svg", "XML", 0, 0, 11, 0, 0, 1, 12
"c:\Users\syedh\OneDrive\Desktop\Antive\src\OfficialLandingPage\Sections\PlainServices\images\svg-decorator-blob-4.svg", "XML", 0, 0, 7, 0, 0, 1, 8
"c:\Users\syedh\OneDrive\Desktop\Antive\src\OfficialLandingPage\Sections\PlainServices\images\svg-decorator-blob-5.svg", "XML", 0, 0, 7, 0, 0, 1, 8
"c:\Users\syedh\OneDrive\Desktop\Antive\src\OfficialLandingPage\Sections\PlainServices\images\svg-decorator-blob-6.svg", "XML", 0, 0, 11, 0, 0, 1, 12
"c:\Users\syedh\OneDrive\Desktop\Antive\src\OfficialLandingPage\Sections\PlainServices\images\svg-decorator-blob-7.svg", "XML", 0, 0, 7, 0, 0, 1, 8
"c:\Users\syedh\OneDrive\Desktop\Antive\src\OfficialLandingPage\Sections\PlainServices\images\svg-decorator-blob-8.svg", "XML", 0, 0, 7, 0, 0, 1, 8
"c:\Users\syedh\OneDrive\Desktop\Antive\src\OfficialLandingPage\Sections\PlainServices\images\svg-decorator-blob-9.svg", "XML", 0, 0, 7, 0, 0, 1, 8
"c:\Users\syedh\OneDrive\Desktop\Antive\src\OfficialLandingPage\Sections\PlainServices\images\team-illustration-2 copy.svg", "XML", 0, 0, 1, 0, 0, 0, 1
"c:\Users\syedh\OneDrive\Desktop\Antive\src\OfficialLandingPage\Sections\PlainServices\images\team-illustration-2.svg", "XML", 0, 0, 1, 0, 0, 0, 1
"c:\Users\syedh\OneDrive\Desktop\Antive\src\OfficialLandingPage\Sections\PlainServices\images\team-illustration-3.svg", "XML", 0, 0, 1, 0, 0, 0, 1
"c:\Users\syedh\OneDrive\Desktop\Antive\src\OfficialLandingPage\Sections\PlainServices\images\team-illustration.svg", "XML", 0, 0, 1, 0, 0, 0, 1
"c:\Users\syedh\OneDrive\Desktop\Antive\src\OfficialLandingPage\Sections\PlainServices\images\twitter-icon.svg", "XML", 0, 0, 3, 0, 0, 1, 4
"c:\Users\syedh\OneDrive\Desktop\Antive\src\OfficialLandingPage\Sections\PlainServices\images\undraw_Online_chat_re_c4lx.svg", "XML", 0, 0, 1, 0, 0, 0, 1
"c:\Users\syedh\OneDrive\Desktop\Antive\src\OfficialLandingPage\Sections\PlainServices\images\undraw_people_tax5.svg", "XML", 0, 0, 1, 0, 0, 0, 1
"c:\Users\syedh\OneDrive\Desktop\Antive\src\OfficialLandingPage\Sections\PlainServices\images\undraw_transfer_money_rywa.svg", "XML", 0, 0, 1, 0, 0, 0, 1
"c:\Users\syedh\OneDrive\Desktop\Antive\src\OfficialLandingPage\Sections\PlainServices\images\youtube-icon.svg", "XML", 0, 0, 3, 0, 0, 1, 4
"c:\Users\syedh\OneDrive\Desktop\Antive\src\OfficialLandingPage\Sections\PlainServices\misc\Buttons.js", "JavaScript", 2, 0, 0, 0, 0, 1, 3
"c:\Users\syedh\OneDrive\Desktop\Antive\src\OfficialLandingPage\Sections\PlainServices\misc\Headings.js", "JavaScript", 3, 0, 0, 0, 0, 2, 5
"c:\Users\syedh\OneDrive\Desktop\Antive\src\OfficialLandingPage\Sections\PlainServices\misc\Layouts.js", "JavaScript", 6, 0, 0, 0, 0, 2, 8
"c:\Users\syedh\OneDrive\Desktop\Antive\src\OfficialLandingPage\Sections\PlainTestimonials\TwoColRate+Img.js", "JavaScript", 141, 0, 0, 0, 0, 11, 152
"c:\Users\syedh\OneDrive\Desktop\Antive\src\OfficialLandingPage\Sections\Services\index.js", "JavaScript", 336, 0, 0, 0, 25, 42, 403
"c:\Users\syedh\OneDrive\Desktop\Antive\src\OfficialLandingPage\Sections\Testimonials\index.js", "JavaScript", 104, 0, 0, 0, 6, 16, 126
"c:\Users\syedh\OneDrive\Desktop\Antive\src\OfficialLandingPage\assets\Arrow Right.svg", "XML", 0, 0, 10, 0, 0, 1, 11
"c:\Users\syedh\OneDrive\Desktop\Antive\src\OfficialLandingPage\assets\Budget.svg", "XML", 0, 0, 1, 0, 0, 0, 1
"c:\Users\syedh\OneDrive\Desktop\Antive\src\OfficialLandingPage\assets\Chat.svg", "XML", 0, 0, 1, 0, 0, 0, 1
"c:\Users\syedh\OneDrive\Desktop\Antive\src\OfficialLandingPage\assets\Design.svg", "XML", 0, 0, 1, 0, 0, 0, 1
"c:\Users\syedh\OneDrive\Desktop\Antive\src\OfficialLandingPage\assets\Develope.svg", "XML", 0, 0, 1, 0, 0, 0, 1
"c:\Users\syedh\OneDrive\Desktop\Antive\src\OfficialLandingPage\assets\HeroImage.svg", "XML", 0, 0, 1, 0, 0, 0, 1
"c:\Users\syedh\OneDrive\Desktop\Antive\src\OfficialLandingPage\assets\Summary.svg", "XML", 0, 0, 1, 0, 0, 0, 1
"c:\Users\syedh\OneDrive\Desktop\Antive\src\OfficialLandingPage\assets\Support.svg", "XML", 0, 0, 1, 0, 0, 0, 1
"c:\Users\syedh\OneDrive\Desktop\Antive\src\OfficialLandingPage\assets\TeamAbout.svg", "XML", 0, 0, 1, 0, 0, 0, 1
"c:\Users\syedh\OneDrive\Desktop\Antive\src\OfficialLandingPage\assets\TodoList.svg", "XML", 0, 0, 1, 0, 0, 0, 1
"c:\Users\syedh\OneDrive\Desktop\Antive\src\OfficialLandingPage\assets\Vault.svg", "XML", 0, 0, 1, 0, 0, 0, 1
"c:\Users\syedh\OneDrive\Desktop\Antive\src\OfficialLandingPage\assets\arrow-up.svg", "XML", 0, 0, 1, 0, 0, 0, 1
"c:\Users\syedh\OneDrive\Desktop\Antive\src\OfficialLandingPage\assets\envelope-open-solid.svg", "XML", 0, 0, 1, 0, 0, 0, 1
"c:\Users\syedh\OneDrive\Desktop\Antive\src\OfficialLandingPage\assets\facebook-square-brands.svg", "XML", 0, 0, 1, 0, 0, 0, 1
"c:\Users\syedh\OneDrive\Desktop\Antive\src\OfficialLandingPage\assets\hand.svg", "XML", 0, 0, 9, 0, 0, 1, 10
"c:\Users\syedh\OneDrive\Desktop\Antive\src\OfficialLandingPage\assets\human.svg", "XML", 0, 0, 14, 0, 0, 1, 15
"c:\Users\syedh\OneDrive\Desktop\Antive\src\OfficialLandingPage\assets\instagram-square-brands.svg", "XML", 0, 0, 1, 0, 0, 0, 1
"c:\Users\syedh\OneDrive\Desktop\Antive\src\OfficialLandingPage\assets\linkedin-brands.svg", "XML", 0, 0, 1, 0, 0, 0, 1
"c:\Users\syedh\OneDrive\Desktop\Antive\src\OfficialLandingPage\assets\logo.svg", "XML", 0, 0, 87, 0, 0, 1, 88
"c:\Users\syedh\OneDrive\Desktop\Antive\src\OfficialLandingPage\assets\mobile.svg", "XML", 0, 0, 1, 0, 0, 0, 1
"c:\Users\syedh\OneDrive\Desktop\Antive\src\OfficialLandingPage\assets\twitter-square-brands.svg", "XML", 0, 0, 1, 0, 0, 0, 1
"c:\Users\syedh\OneDrive\Desktop\Antive\src\OfficialLandingPage\assets\waves.svg", "XML", 0, 0, 3, 0, 0, 1, 4
"c:\Users\syedh\OneDrive\Desktop\Antive\src\OfficialLandingPage\assets\waves2.0.svg", "XML", 0, 0, 1, 0, 0, 0, 1
"c:\Users\syedh\OneDrive\Desktop\Antive\src\OfficialLandingPage\assets\waves@0.5x.svg", "XML", 0, 0, 3, 0, 0, 1, 4
"c:\Users\syedh\OneDrive\Desktop\Antive\src\OfficialLandingPage\assets\waves@0.75x.svg", "XML", 0, 0, 3, 0, 0, 1, 4
"c:\Users\syedh\OneDrive\Desktop\Antive\src\OfficialLandingPage\components\Card\index.js", "JavaScript", 72, 0, 0, 0, 1, 10, 83
"c:\Users\syedh\OneDrive\Desktop\Antive\src\OfficialLandingPage\components\FAQS\SingleCol.js", "JavaScript", 120, 0, 0, 0, 1, 8, 129
"c:\Users\syedh\OneDrive\Desktop\Antive\src\OfficialLandingPage\components\FAQS\misc\HeadingMisc.js", "JavaScript", 3, 0, 0, 0, 0, 2, 5
"c:\Users\syedh\OneDrive\Desktop\Antive\src\OfficialLandingPage\components\FAQS\misc\Layouts.js", "JavaScript", 6, 0, 0, 0, 0, 2, 8
"c:\Users\syedh\OneDrive\Desktop\Antive\src\OfficialLandingPage\components\FAQS\misc\Typography.js", "JavaScript", 2, 0, 0, 0, 0, 1, 3
"c:\Users\syedh\OneDrive\Desktop\Antive\src\OfficialLandingPage\components\Footer\index.js", "JavaScript", 70, 0, 0, 0, 1, 5, 76
"c:\Users\syedh\OneDrive\Desktop\Antive\src\OfficialLandingPage\components\Header\index.js", "JavaScript", 244, 0, 0, 0, 10, 22, 276
"c:\Users\syedh\OneDrive\Desktop\Antive\src\OfficialLandingPage\components\ScrollToTop\index.js", "JavaScript", 0, 0, 0, 0, 68, 8, 76
"c:\Users\syedh\OneDrive\Desktop\Antive\src\OfficialLandingPage\components\SvgBlock\index.js", "JavaScript", 25, 0, 0, 0, 2, 4, 31
"c:\Users\syedh\OneDrive\Desktop\Antive\src\OfficialLandingPage\components\TextBlock\index.js", "JavaScript", 67, 0, 0, 0, 1, 11, 79
"c:\Users\syedh\OneDrive\Desktop\Antive\src\OfficialLandingPage\globalStyles.js", "JavaScript", 62, 0, 0, 0, 1, 14, 77
"c:\Users\syedh\OneDrive\Desktop\Antive\src\OfficialLandingPage\logo.svg", "XML", 0, 0, 1, 0, 0, 0, 1
"c:\Users\syedh\OneDrive\Desktop\Antive\src\OfficialLogin\OfficialLogin.js", "JavaScript", 123, 0, 0, 0, 0, 10, 133
"c:\Users\syedh\OneDrive\Desktop\Antive\src\OfficialLogin\OfficialLoginElements.css", "CSS", 0, 266, 0, 0, 600, 35, 901
"c:\Users\syedh\OneDrive\Desktop\Antive\src\OfficialLogin\image\login.svg", "XML", 0, 0, 1, 0, 0, 0, 1
"c:\Users\syedh\OneDrive\Desktop\Antive\src\OfficialLogin\toastInfo.js", "JavaScript", 14, 0, 0, 0, 0, 1, 15
"c:\Users\syedh\OneDrive\Desktop\Antive\src\OfficialNavbar\ChakraNav\NavHoverBox.js", "JavaScript", 39, 0, 0, 0, 0, 1, 40
"c:\Users\syedh\OneDrive\Desktop\Antive\src\OfficialNavbar\ChakraNav\NavItem.js", "JavaScript", 47, 0, 0, 0, 0, 1, 48
"c:\Users\syedh\OneDrive\Desktop\Antive\src\OfficialNavbar\ChakraNav\OfficialNavChakra.js", "JavaScript", 131, 0, 0, 0, 5, 7, 143
"c:\Users\syedh\OneDrive\Desktop\Antive\src\OfficialNavbar\ChakraNav\globals.css", "CSS", 0, 105, 0, 0, 0, 16, 121
"c:\Users\syedh\OneDrive\Desktop\Antive\src\OfficialNavbar\ChakraNav\pages\OfficialSidebar.js", "JavaScript", 13, 0, 0, 0, 0, 3, 16
"c:\Users\syedh\OneDrive\Desktop\Antive\src\OfficialNavbar\OfficialNav.css", "CSS", 0, 5, 0, 0, 5, 1, 11
"c:\Users\syedh\OneDrive\Desktop\Antive\src\OfficialNavbar\OfficialNav.js", "JavaScript", 312, 0, 0, 0, 16, 28, 356
"c:\Users\syedh\OneDrive\Desktop\Antive\src\OfficialNavbar\assets\All Mail.svg", "XML", 0, 0, 1, 0, 0, 0, 1
"c:\Users\syedh\OneDrive\Desktop\Antive\src\OfficialNavbar\assets\Forum.svg", "XML", 0, 0, 1, 0, 0, 0, 1
"c:\Users\syedh\OneDrive\Desktop\Antive\src\OfficialNavbar\assets\draft.svg", "XML", 0, 0, 1, 0, 0, 0, 1
"c:\Users\syedh\OneDrive\Desktop\Antive\src\OfficialNavbar\assets\home-solid.svg", "XML", 0, 0, 1, 0, 0, 0, 1
"c:\Users\syedh\OneDrive\Desktop\Antive\src\OfficialNavbar\assets\important.svg", "XML", 0, 0, 1, 0, 0, 0, 1
"c:\Users\syedh\OneDrive\Desktop\Antive\src\OfficialNavbar\assets\inbox.svg", "XML", 0, 0, 1, 0, 0, 0, 1
"c:\Users\syedh\OneDrive\Desktop\Antive\src\OfficialNavbar\assets\logo.svg", "XML", 0, 0, 87, 0, 0, 1, 88
"c:\Users\syedh\OneDrive\Desktop\Antive\src\OfficialNavbar\assets\meeting.svg", "XML", 0, 0, 1, 0, 0, 0, 1
"c:\Users\syedh\OneDrive\Desktop\Antive\src\OfficialNavbar\assets\power-off-solid.svg", "XML", 0, 0, 1, 0, 0, 0, 1
"c:\Users\syedh\OneDrive\Desktop\Antive\src\OfficialNavbar\assets\sceduled.svg", "XML", 0, 0, 1, 0, 0, 0, 1
"c:\Users\syedh\OneDrive\Desktop\Antive\src\OfficialNavbar\assets\sent.svg", "XML", 0, 0, 1, 0, 0, 0, 1
"c:\Users\syedh\OneDrive\Desktop\Antive\src\OfficialNavbar\assets\settings.svg", "XML", 0, 0, 1, 0, 0, 0, 1
"c:\Users\syedh\OneDrive\Desktop\Antive\src\OfficialNavbar\assets\snooze.svg", "XML", 0, 0, 1, 0, 0, 0, 1
"c:\Users\syedh\OneDrive\Desktop\Antive\src\OfficialNavbar\assets\social.svg", "XML", 0, 0, 1, 0, 0, 0, 1
"c:\Users\syedh\OneDrive\Desktop\Antive\src\OfficialNavbar\assets\spam.svg", "XML", 0, 0, 1, 0, 0, 0, 1
"c:\Users\syedh\OneDrive\Desktop\Antive\src\OfficialNavbar\assets\starred.svg", "XML", 0, 0, 1, 0, 0, 0, 1
"c:\Users\syedh\OneDrive\Desktop\Antive\src\OfficialNavbar\assets\trash.svg", "XML", 0, 0, 1, 0, 0, 0, 1
"c:\Users\syedh\OneDrive\Desktop\Antive\src\OfficialSignup\OfficialSignup.css", "CSS", 0, 266, 0, 0, 13, 31, 310
"c:\Users\syedh\OneDrive\Desktop\Antive\src\OfficialSignup\OfficialSignup.js", "JavaScript", 111, 0, 0, 0, 0, 11, 122
"c:\Users\syedh\OneDrive\Desktop\Antive\src\OfficialSignup\image\google.svg", "XML", 0, 0, 21, 0, 0, 1, 22
"c:\Users\syedh\OneDrive\Desktop\Antive\src\OfficialSignup\image\svg-signin.svg", "XML", 0, 0, 28, 0, 0, 1, 29
"c:\Users\syedh\OneDrive\Desktop\Antive\src\PageNotFound\NotFoundElements.js", "JavaScript", 20, 0, 0, 0, 0, 3, 23
"c:\Users\syedh\OneDrive\Desktop\Antive\src\PageNotFound\PageNotFound.css", "CSS", 0, 43, 0, 0, 0, 7, 50
"c:\Users\syedh\OneDrive\Desktop\Antive\src\PageNotFound\PageNotFound.js", "JavaScript", 40, 0, 0, 0, 0, 4, 44
"c:\Users\syedh\OneDrive\Desktop\Antive\src\PageResize\PageResize.css", "CSS", 0, 43, 0, 0, 0, 8, 51
"c:\Users\syedh\OneDrive\Desktop\Antive\src\PageResize\PageResize.js", "JavaScript", 39, 0, 0, 0, 1, 4, 44
"c:\Users\syedh\OneDrive\Desktop\Antive\src\PageResize\PageResizeElements.js", "JavaScript", 20, 0, 0, 0, 0, 3, 23
"c:\Users\syedh\OneDrive\Desktop\Antive\src\PrivacyPolicy\PrivacyPolicy.js", "JavaScript", 293, 0, 0, 0, 1, 15, 309
"c:\Users\syedh\OneDrive\Desktop\Antive\src\PrivacyPolicy\misc\Layouts.js", "JavaScript", 6, 0, 0, 0, 0, 2, 8
"c:\Users\syedh\OneDrive\Desktop\Antive\src\PrivateRoute.js", "JavaScript", 14, 0, 0, 0, 0, 2, 16
"c:\Users\syedh\OneDrive\Desktop\Antive\src\ResizeHeight\PageResize.css", "CSS", 0, 43, 0, 0, 0, 8, 51
"c:\Users\syedh\OneDrive\Desktop\Antive\src\ResizeHeight\PageResize.js", "JavaScript", 27, 0, 0, 0, 16, 4, 47
"c:\Users\syedh\OneDrive\Desktop\Antive\src\ResizeHeight\PageResizeElements.js", "JavaScript", 20, 0, 0, 0, 0, 3, 23
"c:\Users\syedh\OneDrive\Desktop\Antive\src\Sidebar&Header\Header\HeaderComponent.css", "CSS", 0, 121, 0, 0, 8, 23, 152
"c:\Users\syedh\OneDrive\Desktop\Antive\src\Sidebar&Header\Header\index.js", "JavaScript", 103, 0, 0, 0, 6, 10, 119
"c:\Users\syedh\OneDrive\Desktop\Antive\src\Sidebar&Header\SideNavbar\SideElements.js", "JavaScript", 187, 0, 0, 0, 16, 22, 225
"c:\Users\syedh\OneDrive\Desktop\Antive\src\Sidebar&Header\SideNavbar\SideMenu.js", "JavaScript", 33, 0, 0, 0, 0, 6, 39
"c:\Users\syedh\OneDrive\Desktop\Antive\src\Sidebar&Header\SideNavbar\SideNavBar.css", "CSS", 0, 5, 0, 0, 1, 2, 8
"c:\Users\syedh\OneDrive\Desktop\Antive\src\Sidebar&Header\SideNavbar\SidebarData.js", "JavaScript", 37, 0, 0, 0, 9, 4, 50
"c:\Users\syedh\OneDrive\Desktop\Antive\src\Sidebar&Header\SideNavbar\index.js", "JavaScript", 160, 0, 0, 0, 6, 14, 180
"c:\Users\syedh\OneDrive\Desktop\Antive\src\Signin\Form.css", "CSS", 0, 315, 0, 0, 18, 36, 369
"c:\Users\syedh\OneDrive\Desktop\Antive\src\Signin\FormSignup.js", "JavaScript", 77, 0, 0, 0, 6, 7, 90
"c:\Users\syedh\OneDrive\Desktop\Antive\src\Signin\SigninElements.js", "JavaScript", 4, 0, 0, 0, 0, 1, 5
"c:\Users\syedh\OneDrive\Desktop\Antive\src\Signin\context\AuthContext.js", "JavaScript", 50, 0, 0, 0, 106, 28, 184
"c:\Users\syedh\OneDrive\Desktop\Antive\src\Signin\firebase.js", "JavaScript", 34, 0, 0, 0, 0, 7, 41
"c:\Users\syedh\OneDrive\Desktop\Antive\src\Signin\image\google.svg", "XML", 0, 0, 21, 0, 0, 1, 22
"c:\Users\syedh\OneDrive\Desktop\Antive\src\Signin\image\svg-signin.svg", "XML", 0, 0, 28, 0, 0, 1, 29
"c:\Users\syedh\OneDrive\Desktop\Antive\src\Signin\index.js", "JavaScript", 27, 0, 0, 0, 0, 3, 30
"c:\Users\syedh\OneDrive\Desktop\Antive\src\TOS\TermsOfService.js", "JavaScript", 812, 0, 0, 0, 1, 22, 835
"c:\Users\syedh\OneDrive\Desktop\Antive\src\TOS\misc\Layouts.js", "JavaScript", 6, 0, 0, 0, 0, 2, 8
"c:\Users\syedh\OneDrive\Desktop\Antive\src\UpdateProfile\UpdateElemets.js", "JavaScript", 9, 0, 0, 0, 0, 2, 11
"c:\Users\syedh\OneDrive\Desktop\Antive\src\UpdateProfile\image\updatePF.svg", "XML", 0, 0, 1, 0, 0, 0, 1
"c:\Users\syedh\OneDrive\Desktop\Antive\src\UpdateProfile\index.js", "JavaScript", 119, 0, 0, 0, 0, 8, 127
"c:\Users\syedh\OneDrive\Desktop\Antive\src\UpdateProfile\updatePf.js", "JavaScript", 117, 0, 0, 0, 1, 15, 133
"c:\Users\syedh\OneDrive\Desktop\Antive\src\UpdateProfile\updateprofile.css", "CSS", 0, 229, 0, 0, 15, 28, 272
"c:\Users\syedh\OneDrive\Desktop\Antive\src\dashboardCS\DashboardCS.css", "CSS", 0, 12, 0, 0, 0, 2, 14
"c:\Users\syedh\OneDrive\Desktop\Antive\src\dashboardCS\DashboardCs.js", "JavaScript", 12, 0, 0, 0, 0, 3, 15
"c:\Users\syedh\OneDrive\Desktop\Antive\src\index.js", "JavaScript", 14, 0, 0, 0, 0, 2, 16
"c:\Users\syedh\OneDrive\Desktop\Antive\src\pages\agenda.js", "JavaScript", 29, 0, 0, 0, 1, 4, 34
"c:\Users\syedh\OneDrive\Desktop\Antive\src\pages\budget.css", "CSS", 0, 39, 0, 0, 9, 6, 54
"c:\Users\syedh\OneDrive\Desktop\Antive\src\pages\budget.js", "JavaScript", 141, 0, 0, 0, 8, 13, 162
"c:\Users\syedh\OneDrive\Desktop\Antive\src\pages\dashboard.js", "JavaScript", 22, 0, 0, 0, 1, 4, 27
"c:\Users\syedh\OneDrive\Desktop\Antive\src\pages\drive.css", "CSS", 0, 7, 0, 0, 1, 0, 8
"c:\Users\syedh\OneDrive\Desktop\Antive\src\pages\drive.js", "JavaScript", 25, 0, 0, 0, 1, 3, 29
"c:\Users\syedh\OneDrive\Desktop\Antive\src\pages\forgotpass.js", "JavaScript", 10, 0, 0, 0, 0, 3, 13
"c:\Users\syedh\OneDrive\Desktop\Antive\src\pages\index.js", "JavaScript", 28, 0, 0, 0, 0, 4, 32
"c:\Users\syedh\OneDrive\Desktop\Antive\src\pages\login.js", "JavaScript", 10, 0, 0, 0, 0, 3, 13
"c:\Users\syedh\OneDrive\Desktop\Antive\src\pages\note.css", "CSS", 0, 34, 0, 0, 0, 3, 37
"c:\Users\syedh\OneDrive\Desktop\Antive\src\pages\note.js", "JavaScript", 28, 0, 0, 0, 0, 4, 32
"c:\Users\syedh\OneDrive\Desktop\Antive\src\pages\notePage.css", "CSS", 0, 52, 0, 0, 0, 9, 61
"c:\Users\syedh\OneDrive\Desktop\Antive\src\pages\notePage.js", "JavaScript", 22, 0, 0, 0, 0, 8, 30
"c:\Users\syedh\OneDrive\Desktop\Antive\src\pages\officialLandingpage.js", "JavaScript", 32, 0, 0, 0, 5, 7, 44
"c:\Users\syedh\OneDrive\Desktop\Antive\src\pages\pages.css", "CSS", 0, 0, 0, 0, 0, 1, 1
"c:\Users\syedh\OneDrive\Desktop\Antive\src\pages\settings.js", "JavaScript", 18, 0, 0, 0, 0, 3, 21
"c:\Users\syedh\OneDrive\Desktop\Antive\src\pages\signin.js", "JavaScript", 10, 0, 0, 0, 0, 2, 12
"c:\Users\syedh\OneDrive\Desktop\Antive\src\serviceWorker.js", "JavaScript", 98, 0, 0, 0, 0, 11, 109
"c:\Users\syedh\OneDrive\Desktop\Antive\src\tailwind.config.js", "JavaScript", 777, 0, 0, 0, 0, 5, 782
"Total", "-", 11575, 3024, 831, 718, 2439, 1755, 20342